wwwwwwwwswwwwwwwwwww
w........a.........w
w.....b..w..cw.....w
w............w.....w
w.d..........w.....w
w............w.....w
w.....ww.e...w.....w
w.....w.....f......w
w.....w............w
wwwwwwwwwwg........w
w..................w
w..................w
w............h.....w
wwwwwwww...........w
w..................w
w....i........wwwwww
w..................x
w............j.....w
w..................w
wwwwwwwwwwwwwwwwwwww
