wwwwwwwwwwwwwwwwwwww
w..................w
w...a..............w
w..................w
w..............b...w
w.......w..........w
w...........c......s
wwwwwwwwwwwwwwww...w
w..................w
w.....d..e.........w
w...wwwwwwwwwwwwwwww
w...........f......w
w..................w
wwwwwg......h......w
w..................w
x.......i..........w
w.......w..........w
w.......w....j.....w
w.......w..........w
wwwwwwwwwwwwwwwwwwww